time,open,high,low,close,EMA,SMMA,Volume,Bollinger Bars Wicks (Open),Bollinger Bars Wicks (High,Bollinger Bars Wicks (Low),Bollinger Bars Wicks (Close),Bollinger Bars Body (Open),Bollinger Bars Body (High,Bollinger Bars Body (Low),Bollinger Bars Body (Close),RSI,RSI-based MA,Regular Bullish,Regular Bullish Label,Regular Bearish,Regular Bearish Label,Histogram,MACD,Signal,OnBalanceVolume,ATR
1726696800,4.44,4.5,4.44,4.5,4.332827985231242,4.313603170783018,244083,4.5,4.5,4.44,4.44,4.44,4.5,4.44,4.5,65.26783827477874,50.401954768385245,NaN,NaN,NaN,NaN,0.023013531534633272,0.024316664654072895,0.0013031331194396237,-13285600,0.07377088880598136
1726783200,4.5,4.56,4.49,4.5,4.366262388184994,4.3402312892425865,111103,4.56,4.56,4.49,4.49,4.5,4.56,4.49,4.5,65.26783827477875,51.88773930422274,NaN,NaN,NaN,NaN,0.02863967000835671,0.03710272062988551,0.0084630506215288,-13285600,0.07350153960555407
1727042400,4.45,4.6,4.42,4.6,4.413009910547995,4.3773411050650735,55875,4.6,4.6,4.42,4.42,4.45,4.6,4.42,4.6,70.00450047183715,53.797358391847276,NaN,NaN,NaN,NaN,0.036969296145327,0.05467467080318755,0.017705374657860554,-13229725,0.08110857249087162
1727128800,4.58,4.6,4.58,4.59,4.448407928438396,4.4077209471986345,123388,4.6,4.6,4.58,4.58,4.58,4.6,4.58,4.59,68.99124429488351,55.52043912418541,NaN,NaN,NaN,NaN,0.03945255968422788,0.06702107426314541,0.027568514578917527,-13353113,0.07674367445580933
1727215200,4.56,4.58,4.46,4.57,4.4727263427507165,4.430903669027401,36097,4.58,4.58,4.46,4.46,4.56,4.58,4.46,4.57,66.90545932040229,56.86924430565091,NaN,NaN,NaN,NaN,0.037413162629287365,0.07433496786552674,0.03692180523623937,-13389210,0.08054769770896579
1727301600,4.57,4.57,4.55,4.55,4.488181074200573,4.447917430594916,31663,4.57,4.57,4.55,4.55,4.57,4.57,4.55,4.55,64.79582461484725,58.01104354947402,NaN,NaN,NaN,NaN,0.032560685930650084,0.07762266264955198,0.04506197671890189,-13420873,0.07622286215832541
1727388000,4.5,4.5,4.45,4.45,4.480544859360458,4.448214940509927,22641,4.5,4.5,4.45,4.45,4.5,4.5,4.45,4.45,55.391205534976685,58.69492818997004,NaN,NaN,NaN,NaN,0.02101977476163403,0.07133669517094443,0.0503169204093104,-13443514,0.07792122914701642
1727643600,4.5,4.5,4.4,4.45,4.474435887488367,4.4484699490085085,124888,4.5,4.5,4.4,4.4,4.5,4.5,4.4,4.45,55.391205534976685,58.92719177361199,NaN,NaN,NaN,NaN,0.012225534140244812,0.06559883808461642,0.053373303944371606,-13443514,0.07949828420794379
1727730000,4.5,4.5,4.5,4.5,4.479548709990693,4.455831384864436,49689,4.5,4.5,4.5,4.5,4.5,4.5,4.5,4.5,58.85425349197113,59.3539455453474,NaN,NaN,NaN,NaN,0.0087768807570313,0.06434440489066073,0.055567524133629434,-13393825,0.07739126390737637
1727816400,4.5,4.54,4.46,4.54,4.491638967992555,4.467855472740945,21263,4.54,4.54,4.46,4.46,4.5,4.54,4.46,4.54,61.43366736953253,60.25530533605034,NaN,NaN,NaN,NaN,0.008201341077646418,0.06581920048068746,0.05761785940304104,-13372562,0.07757760219970664
1727902800,4.52,4.58,4.52,4.58,4.5093111743940435,4.483876119492239,23609,4.58,4.58,4.52,4.52,4.52,4.58,4.52,4.58,63.87269297260047,61.15786811557532,NaN,NaN,NaN,NaN,0.009438091632110492,0.06941547394317915,0.05997738231106866,-13348953,0.07632205918544191
1727989200,4.6,4.6,4.6,4.6,4.527448939515235,4.500465245279061,28244,4.6,4.6,4.6,4.6,4.6,4.6,4.6,4.6,65.06244171396179,62.20654418996873,NaN,NaN,NaN,NaN,0.01044805349124428,0.073037449175124,0.06258939568387972,-13320709,0.07229905495791031
1728248400,4.57,4.61,4.57,4.6,4.541959151612188,4.514684495953481,29749,4.61,4.61,4.57,4.57,4.57,4.61,4.57,4.6,65.06244171396179,63.38019214018997,NaN,NaN,NaN,NaN,0.009962758216549392,0.07504284345456647,0.06508008523801707,-13320709,0.06999197960377386
1728334800,4.6,4.64,4.6,4.64,4.5615673212897505,4.532586710817269,16489,4.64,4.64,4.6,4.6,4.6,4.64,4.6,4.64,67.54182210789429,63.845888263671654,NaN,NaN,NaN,NaN,0.011095704129999398,0.07894971540051632,0.06785401127051692,-13304220,0.06784969534636144
1728421200,4.63,4.78,4.63,4.74,4.5972538570318005,4.562217180700516,22567,4.78,4.78,4.63,4.63,4.63,4.78,4.63,4.74,72.7485503873406,64.38022484314035,NaN,NaN,NaN,NaN,0.016987311847667025,0.08908815108010071,0.07210083923243368,-13281653,0.07371757425019279
1728507600,4.7,4.74,4.7,4.7,4.61780308562544,4.581900440600442,17323,4.74,4.74,4.7,4.7,4.7,4.74,4.7,4.7,68.0464598377169,64.57869781192166,NaN,NaN,NaN,NaN,0.016579518327285506,0.09282523714154056,0.07624571881425506,-13298976,0.07130917608946473
1728594000,4.7,4.7,4.6,4.6,4.614242468500352,4.584486091943236,14884,4.7,4.7,4.6,4.6,4.7,4.7,4.6,4.6,57.96037685485555,63.71840326785154,NaN,NaN,NaN,NaN,0.008377911455742529,0.08671810813393321,0.07834019667819068,-13313860,0.073358520654503
1728853200,4.65,4.65,4.6,4.6,4.611393974800282,4.586702364522774,5238,4.65,4.65,4.6,4.6,4.65,4.65,4.6,4.6,57.96037685485554,62.93048416499239,NaN,NaN,NaN,NaN,0.0020839065785475397,0.08094507990137512,0.07886117332282758,-13313860,0.07169005489346714
1728939600,4.6,4.6,4.59,4.6,4.6091151798402255,4.588602026733805,27352,4.6,4.6,4.59,4.59,4.6,4.6,4.59,4.6,57.96037685485554,62.29154970316763,NaN,NaN,NaN,NaN,-0.0026892578335922235,0.0754996010308373,0.07818885886442953,-13313860,0.06728362240107662
1729026000,4.51,4.6,4.5,4.5,4.5872921438721805,4.5759445943432615,120890,4.6,4.6,4.5,4.5,4.51,4.6,4.5,4.5,48.906446315925386,61.1565941103875,NaN,NaN,NaN,NaN,-0.012634608759230503,0.0623955979153914,0.0750302066746219,-13434750,0.06962050651528541
1729112400,4.6,4.61,4.5,4.58,4.585833715097745,4.576523938008509,28245,4.61,4.61,4.5,4.5,4.6,4.61,4.5,4.58,54.96699022461702,61.12629301679038,NaN,NaN,NaN,NaN,-0.013784457943929324,0.05779963424471024,0.07158409218863956,-13406505,0.07250475604990791
1729198800,4.56,4.58,4.49,4.5,4.568666972078196,4.565591946864436,48044,4.58,4.58,4.49,4.49,4.56,4.58,4.49,4.5,48.74079436460148,60.65126364747787,NaN,NaN,NaN,NaN,-0.019540588683157334,0.0471583563346929,0.06669894501785023,-13454549,0.07375441633205734
1729458000,4.5,4.55,4.49,4.55,4.564933577662557,4.563364525883802,46485,4.55,4.55,4.49,4.49,4.5,4.55,4.49,4.55,52.37197687152376,60.18824388887448,NaN,NaN,NaN,NaN,-0.019541268326795966,0.04227235960935527,0.061813627936151236,-13408064,0.07277195802262464
1729544400,4.54,4.55,4.5,4.55,4.561946862130045,4.561455307900402,35159,4.55,4.55,4.5,4.5,4.54,4.55,4.5,4.55,52.37197687152376,59.540980281873864,NaN,NaN,NaN,NaN,-0.0190808517848675,0.03796256320506686,0.05704341498993436,-13408064,0.07114538959243714
1729630800,4.54,4.54,4.52,4.54,4.5575574897040365,4.55839026391463,11508,4.54,4.54,4.52,4.52,4.54,4.54,4.52,4.54,51.52534142650448,58.65902660000985,NaN,NaN,NaN,NaN,-0.01895025239997298,0.033355599489968135,0.052305851889941114,-13419572,0.06820643319297737
1729717200,4.53,4.54,4.53,4.53,4.552045991763229,4.554334511926826,13244,4.54,4.54,4.53,4.53,4.53,4.54,4.53,4.53,50.64366886964107,57.62911425398695,NaN,NaN,NaN,NaN,-0.018990030796587683,0.028568313394206513,0.047558344190794195,-13432816,0.0640488308220504
1729803600,4.52,4.52,4.49,4.49,4.539636793410583,4.5451438673658515,9998,4.52,4.52,4.49,4.49,4.52,4.52,4.49,4.49,47.166954930033995,56.35086519799211,NaN,NaN,NaN,NaN,-0.02100576122965992,0.021301142653719296,0.04230690388337922,-13442814,0.062331057191903946
1730149200,4.47,4.52,4.46,4.52,4.535709434728466,4.541551886313587,31290,4.52,4.52,4.46,4.46,4.47,4.52,4.46,4.52,49.942564290010964,55.09377535385759,NaN,NaN,NaN,NaN,-0.019639199352386436,0.017757904692896176,0.03739710404528261,-13411524,0.062164553106767925
1730235600,4.51,4.53,4.48,4.53,4.534567547782773,4.5399016168402175,17640,4.53,4.53,4.48,4.48,4.51,4.53,4.48,4.53,50.86911819069723,53.53095876838306,NaN,NaN,NaN,NaN,-0.017455911181049263,0.015577215068971029,0.03303312625002029,-13393884,0.061295656456284486
1730322000,4.53,4.54,4.5,4.52,4.531654038226218,4.537058528720186,28661,4.54,4.54,4.5,4.5,4.53,4.54,4.5,4.52,49.87492893867881,52.23299227559462,NaN,NaN,NaN,NaN,-0.016111734088670095,0.012893458639182676,0.02900519272785277,-13422545,0.05977453813797846
1730408400,4.5,4.5,4.47,4.47,4.519323230580975,4.527478738903016,63563,4.5,4.5,4.47,4.47,4.5,4.5,4.47,4.47,45.12599297287325,51.31625056973875,NaN,NaN,NaN,NaN,-0.01787994420027686,0.006655262477506696,0.024535206677783555,-13486108,0.05907635684240855
1730667600,4.47,4.48,4.47,4.47,4.50945858446478,4.519267490488299,20232,4.48,4.48,4.47,4.47,4.47,4.48,4.47,4.47,45.12599297287325,50.399508863882865,NaN,NaN,NaN,NaN,-0.018274610618046715,0.0016919434052251603,0.019966554023271875,-13486108,0.05557090278223655
1730754000,4.46,4.52,4.46,4.52,4.511566867571824,4.519372134704256,28254,4.52,4.52,4.46,4.46,4.46,4.52,4.46,4.52,50.58305945511815,49.872557621044486,NaN,NaN,NaN,NaN,-0.01455514266765336,0.0017726256887051761,0.016327768356358536,-13457854,0.055887266869219625
1730840400,4.52,4.52,4.5,4.52,4.51325349405746,4.519461829746506,332311,4.52,4.52,4.5,4.5,4.52,4.52,4.5,4.52,50.58305945511816,49.99231570241539,NaN,NaN,NaN,NaN,-0.011609704731952077,0.0018156374414184384,0.013425342173370516,-13457854,0.053323890664275335
1730926800,4.52,4.52,4.51,4.52,4.514602795245968,4.519538711211291,45322,4.52,4.52,4.51,4.51,4.52,4.52,4.51,4.52,50.58305945511816,49.67917779030832,NaN,NaN,NaN,NaN,-0.009277357672216777,0.0018286450830995449,0.011106002755316322,-13457854,0.05022932704539851
1731013200,4.52,4.53,4.46,4.53,4.517682236196774,4.521033181038249,652707,4.53,4.53,4.46,4.46,4.52,4.53,4.46,4.53,51.78089113747333,49.89632755979918,NaN,NaN,NaN,NaN,-0.006792227969955584,0.002615717792871841,0.009407945762827425,-12805147,0.051641517970727205
1731272400,4.53,4.53,4.49,4.53,4.520145788957419,4.522314155175643,14971,4.53,4.53,4.49,4.49,4.53,4.53,4.49,4.53,51.78089113747333,49.85410715022415,NaN,NaN,NaN,NaN,-0.004964307449432579,0.0032025614510367006,0.00816686890046928,-12805147,0.05080998097281812
1731358800,4.52,4.53,4.49,4.5,4.516116631165935,4.51912641872198,36814,4.53,4.53,4.49,4.49,4.52,4.53,4.49,4.5,47.75356875106608,49.524220855905746,NaN,NaN,NaN,NaN,-0.00554735077962312,0.00123268042594038,0.0067800312055635,-12841961,0.05003783947475969
1731445200,4.5,4.5,4.49,4.49,4.510893304932748,4.514965501761696,529,4.5,4.5,4.49,4.49,4.5,4.5,4.49,4.49,46.45651802735548,49.16216204168082,NaN,NaN,NaN,NaN,-0.006321978637613078,-0.0011224420914528466,0.005199536546160231,-12842490,0.047177993797991126
1731531600,4.49,4.54,4.49,4.51,4.510714643946198,4.514256144367168,45649,4.54,4.54,4.49,4.49,4.49,4.54,4.49,4.51,49.41576358829383,49.074454521584585,NaN,NaN,NaN,NaN,-0.005247141711041524,-0.0013593905926416738,0.00388775111839985,-12796841,0.04737956566956318
1731618000,4.52,4.54,4.5,4.5,4.508571715156958,4.512219552314716,27067,4.54,4.54,4.5,4.5,4.52,4.54,4.5,4.5,47.98766336882971,49.13307655292714,NaN,NaN,NaN,NaN,-0.004972011432551467,-0.0023272631722894843,0.0026447482602619827,-12823908,0.046852453836022954
1731877200,4.5,4.55,4.5,4.55,4.516857372125567,4.517616759126899,20967,4.55,4.55,4.5,4.5,4.5,4.55,4.5,4.55,54.991589245886935,49.49372119263257,NaN,NaN,NaN,NaN,-0.0013721525231674705,0.0009295576063026445,0.002301710129470115,-12802941,0.047077278562021305
1731963600,4.56,4.65,4.56,4.61,4.535485897700453,4.530814364965914,14839,4.65,4.65,4.56,4.56,4.56,4.65,4.56,4.61,61.66302028320012,50.26471419923992,NaN,NaN,NaN,NaN,0.0047641753801847195,0.008256929354701015,0.003492753974516295,-12788102,0.050857472950448394
1732050000,4.62,4.63,4.62,4.63,4.554388718160363,4.544983741399355,60689,4.63,4.63,4.62,4.62,4.62,4.63,4.62,4.63,63.59985205324645,51.24506585028046,NaN,NaN,NaN,NaN,0.009605071388798975,0.015499093210515014,0.005894021821716038,-12727413,0.048653367739702046
1732136400,4.62,4.8,4.62,4.8,4.60351097452829,4.581414635485161,13577,4.8,4.8,4.62,4.62,4.62,4.8,4.62,4.8,75.11039153983754,53.38680860506363,NaN,NaN,NaN,NaN,0.022931005686553277,0.034557778929907634,0.011626773243354357,-12713836,0.058035270044009026
1732222800,4.79,4.79,4.76,4.76,4.634808779622632,4.606926830415852,53059,4.79,4.79,4.76,4.76,4.79,4.79,4.76,4.76,69.5383699598301,55.13054981841769,NaN,NaN,NaN,NaN,0.02742265630334658,0.045905093622537585,0.018482437319191004,-12766895,0.056747036469436955
1732482000,4.74,5.08,4.74,5.08,4.723847023698106,4.674508711785016,105216,5.08,5.08,4.74,4.74,4.74,5.08,4.74,5.08,81.41594722612132,57.332898944917915,NaN,NaN,NaN,NaN,0.049053546503607645,0.07979937044870056,0.030745823945092916,-12661679,0.07697939100733431
1732568400,5.05,5.18,5.03,5.16,4.8110776189584845,4.743864610101442,131197,5.18,5.18,5.03,5.03,5.05,5.18,5.03,5.16,83.18152197577666,59.661360553536376,NaN,NaN,NaN,NaN,0.06486501075365479,0.1118270873871614,0.046962076633506614,-12530482,0.08219514879252467
1732654800,5.11,5.39,5.11,5.39,4.926862095166787,4.836169665801235,85960,5.39,5.39,5.11,5.11,5.11,5.39,5.11,5.39,87.0042238776928,62.262872298005995,NaN,NaN,NaN,NaN,0.0856249175682306,0.15399322359379486,0.06836830602556426,-12444522,0.09632406673591572
1732741200,5.38,5.38,5.3,5.35,5.011489676133429,4.9095739992582015,68483,5.38,5.38,5.3,5.3,5.38,5.38,5.3,5.35,83.45170971546978,64.52507362500573,NaN,NaN,NaN,NaN,0.09097221795760232,0.18208357847256718,0.09111136051496485,-12513005,0.0958723476833503
1732827600,5.33,5.38,5.33,5.38,5.085191740906743,4.976777713649887,190103,5.38,5.38,5.33,5.33,5.33,5.38,5.33,5.38,83.98003687812304,66.82501260648073,NaN,NaN,NaN,NaN,0.09063877328977862,0.20440982712718814,0.11377105383740951,-12322902,0.09259575142025385
1733086800,5.4,5.46,5.39,5.4,5.148153392725394,5.0372380402713315,151963,5.46,5.46,5.39,5.39,5.4,5.46,5.39,5.4,84.33901041493112,69.43825843961393,NaN,NaN,NaN,NaN,0.08591746665806105,0.2211678871599858,0.13525042050192476,-12170939,0.09169605489023572
1733173200,5.41,5.41,5.28,5.36,5.190522714180315,5.083346891661142,16475,5.41,5.41,5.28,5.28,5.41,5.41,5.28,5.36,80.45595323579413,71.86678952593098,NaN,NaN,NaN,NaN,0.07466854873472087,0.22858610642032584,0.15391755768560497,-12187414,0.09443205096950459
1733259600,5.35,5.36,5.17,5.25,5.202418171344252,5.1071544785666925,65904,5.36,5.36,5.17,5.17,5.35,5.36,5.17,5.25,70.80194137448817,73.39437365351628,NaN,NaN,NaN,NaN,0.05528051618643712,0.22301820291865138,0.16773768673221426,-12253318,0.10125833304311142
1733346000,5.22,5.33,5.22,5.32,5.225934537075402,5.137560981628594,19386,5.33,5.33,5.22,5.22,5.22,5.33,5.22,5.32,73.02051259825673,75.18243431276107,NaN,NaN,NaN,NaN,0.04316858098417009,0.22169841296242687,0.17852983197825678,-12233932,0.10188273782574633
1733432400,5.32,5.32,5.26,5.32,5.2447476296603215,5.163623698538795,21290,5.32,5.32,5.26,5.26,5.32,5.32,5.26,5.32,73.02051259825673,76.47021455221605,NaN,NaN,NaN,NaN,0.03168646389887639,0.21813791185185227,0.18645144795297589,-12233932,0.09889111369533592
1733691600,5.26,5.32,5.26,5.3,5.2557981037282575,5.183106027318966,62342,5.32,5.32,5.26,5.26,5.26,5.32,5.26,5.3,71.22715732643809,77.15336719816163,NaN,NaN,NaN,NaN,0.019852443021515925,0.21126700172987078,0.19141455870835486,-12296274,0.09611317700281195
1733778000,5.3,5.3,5.28,5.3,5.264638482982606,5.199805166273399,11878,5.3,5.3,5.28,5.28,5.3,5.3,5.28,5.3,71.22715732643809,77.69817471767531,NaN,NaN,NaN,NaN,0.0096493201369528,0.20347620887954587,0.19382688874259307,-12296274,0.09067652150261107
1733864400,5.3,5.38,5.3,5.33,5.277710786386084,5.218404428234342,32341,5.38,5.38,5.3,5.3,5.3,5.38,5.3,5.33,72.4061064575252,77.50501149751015,NaN,NaN,NaN,NaN,0.00289581424208038,0.19744665654519356,0.19455084230311318,-12263933,0.08991391282385315
1733950800,5.38,5.7,5.38,5.62,5.346168629108868,5.275775224200864,207447,5.7,5.7,5.38,5.38,5.38,5.7,5.38,5.62,80.65695432552155,78.29919609505954,NaN,NaN,NaN,NaN,0.01524448383097965,0.21360644709183774,0.1983619632608581,-12056486,0.10992006190786364
1734037200,5.56,5.56,5.5,5.5,5.376934903287094,5.307807335029312,22672,5.56,5.56,5.5,5.5,5.56,5.56,5.5,5.5,71.17339801354245,77.5675854370182,NaN,NaN,NaN,NaN,0.01271870184987725,0.21426034057320464,0.2015416387233274,-12079158,0.11064005748587338
1734296400,5.5,5.5,5.4,5.45,5.391547922629676,5.328120572882268,26456,5.5,5.5,5.4,5.4,5.5,5.5,5.4,5.45,67.60649523029375,76.45508352662657,NaN,NaN,NaN,NaN,0.00544055542880878,0.20834233300933835,0.20290177758052957,-12105614,0.10988005337973954
1734382800,5.45,5.56,5.44,5.56,5.425238338103741,5.361246205327658,28062,5.56,5.56,5.44,5.44,5.45,5.56,5.44,5.56,71.04453913096009,75.31510604471707,NaN,NaN,NaN,NaN,0.0057636775918211425,0.210106374570306,0.20434269697848487,-12077552,0.11060290670975807
1734469200,5.46,5.52,5.46,5.49,5.438190670482992,5.379639604566564,19040,5.52,5.52,5.46,5.46,5.46,5.52,5.46,5.49,66.22748237361265,74.08480409172728,NaN,NaN,NaN,NaN,-0.0006661270297113053,0.20351003819134572,0.20417616522105703,-12096592,0.10984555623048961
1734555600,5.44,5.44,5.3,5.35,5.420552536386394,5.37540537534277,36992,5.44,5.44,5.3,5.3,5.44,5.44,5.3,5.35,57.788210343591764,72.21395933926077,NaN,NaN,NaN,NaN,-0.015457192579848067,0.18485467449624693,0.200311867076095,-12133584,0.11557087364259752
1734642000,5.37,5.37,5.27,5.27,5.390442029109115,5.360347464579517,40056,5.37,5.37,5.27,5.27,5.37,5.37,5.27,5.27,53.58611729060751,70.01732411609478,NaN,NaN,NaN,NaN,-0.03084927250065833,0.16175027645027207,0.1925995489509304,-12173640,0.11445866838241202
1734901200,5.27,5.29,5.25,5.29,5.370353623287293,5.350297826782443,19752,5.29,5.29,5.25,5.25,5.27,5.29,5.25,5.29,54.47732490323837,68.16170780662652,NaN,NaN,NaN,NaN,-0.03935910020780678,0.14340067369117193,0.1827597738989787,-12153888,0.1091401920693826
1734987600,5.29,5.4,5.29,5.4,5.376282898629834,5.357398137242093,15754,5.4,5.4,5.29,5.29,5.29,5.4,5.29,5.4,59.125964505808696,67.32770945886371,NaN,NaN,NaN,NaN,-0.03727586923409104,0.13616493735636492,0.17344080659045596,-12138134,0.10920160692156958
1735246800,5.4,5.46,5.3,5.3,5.361026318903868,5.349198403350365,965,5.46,5.46,5.3,5.3,5.4,5.46,5.3,5.3,53.75211321993368,65.95139521755492,NaN,NaN,NaN,NaN,-0.04197907086646918,0.1209669680073695,0.16294603887383868,-12139099,0.11283006357002891
1735506000,5.33,5.5,5.33,5.5,5.388821055123094,5.370741488586027,11250,5.5,5.5,5.33,5.33,5.33,5.5,5.33,5.5,61.32340986995876,65.11588787981935,NaN,NaN,NaN,NaN,-0.031448349440760776,0.12363560207288771,0.15508395151364848,-12127849,0.11905648760074114
1735592400,5.5,5.51,5.5,5.5,5.411056844098475,5.389206990216595,6679,5.51,5.51,5.5,5.5,5.5,5.51,5.5,5.5,61.32340986995876,64.40847734721369,NaN,NaN,NaN,NaN,-0.02461319360451586,0.12431745950800366,0.14893065311251952,-12127849,0.11126673848640246
1735851600,5.65,5.65,5.57,5.57,5.44284547527878,5.415034563042796,2920,5.65,5.65,5.57,5.57,5.65,5.65,5.57,5.57,63.733438291450796,63.87321170185745,NaN,NaN,NaN,NaN,-0.01592932193403973,0.12901900069496985,0.14494832262900958,-12124929,0.11403340002308802
1736110800,5.63,5.65,5.56,5.56,5.466276380223024,5.43574391117954,18523,5.65,5.65,5.56,5.56,5.63,5.65,5.56,5.56,63.12825847117392,63.210508274260924,NaN,NaN,NaN,NaN,-0.011611040855184385,0.1304345215600291,0.1420455624152135,-12143452,0.1123167285928675
1736197200,5.62,5.63,5.56,5.56,5.485021104178419,5.4534947810110355,16660,5.63,5.63,5.56,5.56,5.62,5.63,5.56,5.56,63.12825847117392,61.95845857037896,NaN,NaN,NaN,NaN,-0.0095907582644294,0.13005711458467673,0.13964787284910612,-12143452,0.1092941051219484
1736283600,5.55,5.55,5.4,5.4,5.468016883342735,5.445852669438031,60144,5.55,5.55,5.4,5.4,5.55,5.55,5.4,5.4,53.6713542108594,60.70831258447301,NaN,NaN,NaN,NaN,-0.01930569009088373,0.11551576023550147,0.1348214503263852,-12203596,0.11291595475609488
1736370000,5.38,5.46,5.35,5.36,5.4464135066741886,5.433588002375454,25326,5.46,5.46,5.35,5.35,5.38,5.46,5.35,5.36,51.59060150864764,59.56432017578401,NaN,NaN,NaN,NaN,-0.028164632954679247,0.09961565913303616,0.1277802920877154,-12228922,0.1127076722735167
1736456400,5.36,5.44,5.36,5.37,5.431130805339351,5.424504002036103,3649,5.44,5.44,5.36,5.36,5.36,5.44,5.36,5.37,52.09066226511584,58.21047182822371,NaN,NaN,NaN,NaN,-0.03276758200980656,0.0868208145754572,0.11958839658526377,-12225273,0.11037140996826553
1736715600,5.35,5.39,5.35,5.35,5.4149046442714805,5.413860573173802,29256,5.39,5.39,5.35,5.35,5.35,5.39,5.35,5.35,50.95692868509732,57.11971799332975,NaN,NaN,NaN,NaN,-0.03630150836940889,0.07421151112350266,0.11051301949291155,-12254529,0.10534488068481798
1736802000,5.36,5.37,5.35,5.36,5.403923715417185,5.406166205577544,22257,5.37,5.37,5.35,5.35,5.36,5.37,5.35,5.36,51.525026862576965,56.672347744685844,NaN,NaN,NaN,NaN,-0.036982869359416665,0.06428443279364071,0.10126730215305738,-12232272,0.09924881777875959
1736888400,5.35,5.4,5.35,5.39,5.401138972333748,5.403856747637895,16324,5.4,5.4,5.35,5.35,5.35,5.4,5.35,5.39,53.27371718809269,56.650033451649065,NaN,NaN,NaN,NaN,-0.03447993485365697,0.058167383585986165,0.09264731843964313,-12215948,0.09573104508027681
1736974800,5.39,5.42,5.39,5.4,5.400911177866998,5.403305783689624,12159,5.42,5.42,5.39,5.39,5.39,5.42,5.39,5.4,53.87107166669146,56.60672964903857,NaN,NaN,NaN,NaN,-0.0313101201141472,0.053509668296959134,0.08481978841110634,-12203789,0.09103597043168564
1737061200,5.42,5.42,5.36,5.36,5.392728942293599,5.3971192431625346,50806,5.42,5.42,5.36,5.36,5.42,5.42,5.36,5.36,51.05923635397386,56.03053478105038,NaN,NaN,NaN,NaN,-0.0310080057840144,0.04605978118108833,0.07706778696510273,-12254595,0.08881911540085093
1737320400,5.42,5.42,5.36,5.36,5.386183153834879,5.391816494139315,10663,5.42,5.42,5.36,5.36,5.42,5.42,5.36,5.36,51.05923635397387,55.838186433481816,NaN,NaN,NaN,NaN,-0.029895767776131774,0.03969807724493801,0.06959384502106979,-12254595,0.08676060715793298
1737406800,5.4,5.42,5.4,5.42,5.392946523067903,5.39584270926227,18218,5.42,5.42,5.4,5.4,5.4,5.42,5.4,5.42,55.13322440589194,55.39603032890561,NaN,NaN,NaN,NaN,-0.024436866964884618,0.039047761314964013,0.06348462827984863,-12236377,0.08484913521808059
1737493200,5.41,5.45,5.36,5.45,5.404357218454322,5.403579465081947,24177,5.45,5.45,5.36,5.36,5.41,5.45,5.36,5.45,57.05802486353429,55.09135997130386,NaN,NaN,NaN,NaN,-0.018398560069920356,0.04048642819244819,0.05888498826236854,-12212200,0.08521705413107482
1737579600,5.41,5.49,5.41,5.49,5.4214857747634575,5.4159252557845265,71104,5.49,5.49,5.41,5.41,5.41,5.49,5.41,5.49,59.54977891634255,54.792527158796126,NaN,NaN,NaN,NaN,-0.011633520013682917,0.044343088245264894,0.05597660825894781,-12141096,0.08484440740742662
1737666000,5.49,5.49,5.41,5.41,5.419188619810766,5.415078790672451,18789,5.49,5.49,5.41,5.41,5.49,5.49,5.41,5.41,52.93411421014984,54.0643739972944,NaN,NaN,NaN,NaN,-0.0123992167823576,0.040477587281000815,0.052876804063358415,-12159885,0.08449837830689615
1737925200,5.45,5.45,5.36,5.36,5.407350895848613,5.4072103920049575,2615,5.45,5.45,5.36,5.36,5.45,5.45,5.36,5.36,49.25133217842052,53.07316497638345,NaN,NaN,NaN,NaN,-0.01590210417072123,0.032999173849956875,0.048901278020678104,-12162500,0.08489135128497498
1738011600,5.44,5.44,5.36,5.38,5.401880716678891,5.4033231931471075,22791,5.44,5.44,5.36,5.36,5.44,5.44,5.36,5.38,50.72800798931594,52.86292596055892,NaN,NaN,NaN,NaN,-0.01643350188686038,0.02835940066210263,0.04479290254896301,-12139709,0.08454196905033391
1738098000,5.45,5.46,5.41,5.41,5.403504573343112,5.40427702269752,44053,5.46,5.46,5.41,5.41,5.45,5.46,5.41,5.41,52.940023475900595,52.959313243934126,NaN,NaN,NaN,NaN,-0.014398938784266013,0.026794229068630493,0.041193167852896506,-12095656,0.08421754268959579
1738184400,5.41,5.48,5.41,5.48,5.41880365867449,5.415094590883588,49539,5.48,5.48,5.41,5.41,5.41,5.48,5.41,5.48,57.7107003699008,53.360744537133066,NaN,NaN,NaN,NaN,-0.008277211664402803,0.030846653272393,0.0391238649367958,-12046117,0.08320200392605326
1738270800,5.5,5.5,5.43,5.48,5.4310429269395915,5.424366792185934,17447,5.5,5.5,5.43,5.43,5.5,5.5,5.43,5.48,57.7107003699008,53.843156800333304,NaN,NaN,NaN,NaN,-0.004363011398883142,0.03367010068819187,0.038033112087075015,-12046117,0.0822590036456209
1738530000,5.41,5.48,5.41,5.48,5.440834341551673,5.432314393302229,26744,5.48,5.48,5.41,5.41,5.41,5.48,5.41,5.48,57.7107003699008,54.284990622285015,NaN,NaN,NaN,NaN,-0.002027690859067968,0.03549849851324005,0.03752618937230802,-12046117,0.08138336052807657
1738616400,5.42,5.5,5.42,5.48,5.448667473241338,5.439126622830481,129269,5.5,5.5,5.42,5.42,5.42,5.5,5.42,5.48,57.7107003699008,54.60191799241416,NaN,NaN,NaN,NaN,-0.0007997813873446558,0.0365264626381272,0.037326244025471855,-12046117,0.0812845490617854
1738702800,5.5,5.55,5.48,5.55,5.46893397859307,5.454965676711841,25272,5.55,5.55,5.48,5.48,5.5,5.55,5.48,5.55,62.785091987877884,55.23863372964177,NaN,NaN,NaN,NaN,0.0041387145682813195,0.042499637235823506,0.03836092266754219,-12020845,0.0804785098430864
1738875600,5.7,5.7,5.57,5.64,5.503147182874456,5.481399151467293,13430,5.7,5.7,5.57,5.57,5.7,5.7,5.57,5.64,68.08718933040942,56.454916085101445,NaN,NaN,NaN,NaN,0.01241097043621632,0.05387463571281259,0.04146366527659627,-12007415,0.08544433056858025
1739134800,5.58,5.65,5.56,5.65,5.532517746299565,5.505484986971965,7419,5.65,5.65,5.56,5.56,5.58,5.65,5.56,5.65,68.62211881352735,57.70940768935527,NaN,NaN,NaN,NaN,0.017205416892153748,0.06297043639178845,0.045765019499634706,-11999996,0.08576973552796743
1739221200,5.65,5.7,5.6,5.7,5.566014197039652,5.53327284597597,31911,5.7,5.7,5.6,5.6,5.65,5.7,5.6,5.7,71.2197677726859,58.858446501269114,NaN,NaN,NaN,NaN,0.022082198906660307,0.07336776813296009,0.05128556922629978,-11968085,0.08678618299025552
1739307600,5.6,5.64,5.6,5.64,5.580811357631721,5.548519582265117,3646,5.64,5.64,5.6,5.6,5.6,5.64,5.6,5.64,64.33670699347292,59.37835236769331,NaN,NaN,NaN,NaN,0.019684665464451807,0.07589140105686454,0.05620673559241273,-11971731,0.08773002706238017
1739394000,5.59,5.6,5.56,5.56,5.576649086105377,5.550159641941529,44370,5.6,5.6,5.56,5.56,5.59,5.6,5.56,5.56,56.49652399847581,59.160262730702826,NaN,NaN,NaN,NaN,0.011532196074914583,0.07062198068605596,0.05908978461114138,-12016101,0.08717788227221016
1739480400,5.58,5.58,5.56,5.56,5.573319268884301,5.551565407378454,28190,5.58,5.58,5.56,5.56,5.58,5.58,5.56,5.56,56.49652399847581,59.41472057272612,NaN,NaN,NaN,NaN,0.0052791391397805434,0.06568870853586706,0.060409569396086514,-12016101,0.08237946210990946
1739739600,5.55,5.65,5.55,5.64,5.586655415107441,5.564198920610103,23044,5.65,5.65,5.55,5.55,5.55,5.65,5.55,5.64,61.883551215384564,60.31702193250926,NaN,NaN,NaN,NaN,0.005637773590011483,0.06745678638360086,0.06181901279358938,-11993057,0.08363807195920168
1739826000,5.65,5.92,5.65,5.92,5.653324332085953,5.615027646237231,104428,5.92,5.92,5.65,5.65,5.65,5.92,5.65,5.92,74.01286708354205,61.980226153525415,NaN,NaN,NaN,NaN,0.022872371037461453,0.0904094765904162,0.06753710555295475,-11888629,0.09766392396211587
1739912400,5.93,6.21,5.93,6.08,5.738659465668762,5.6814522682033415,77319,6.21,6.21,5.93,5.93,5.93,6.21,5.93,6.08,78.26846766327922,63.78940073833818,NaN,NaN,NaN,NaN,0.042070778654499305,0.12012557887107889,0.07805480021657958,-11811310,0.11140221510767903
1739998800,6.08,6.08,6.02,6.02,5.79492757253501,5.729816229888578,13378,6.08,6.08,6.02,6.02,6.08,6.08,6.02,6.02,73.41341579231138,64.91102326851036,NaN,NaN,NaN,NaN,0.047357878334876646,0.1372521481351754,0.08989426980029874,-11824688,0.10773062831427342
1740085200,6.05,6.05,5.97,6,5.835942058028008,5.7684139113330675,59645,6.05,6.05,5.97,5.97,6.05,6.05,5.97,6,71.81429462975031,65.91842285849961,NaN,NaN,NaN,NaN,0.04609324957407987,0.1475108317678986,0.10141758219381872,-11884333,0.10574986914896818
1740344400,6,6,5.9,5.9,5.848753646422407,5.787211923999772,37343,6,6,5.9,5.9,6,6,5.9,5.9,64.2754350861764,66.38733248109074,NaN,NaN,NaN,NaN,0.035577949338870485,0.14589001886740682,0.11031206952853634,-11921676,0.10533916420975616
1740430800,5.92,5.92,5.75,5.75,5.829002917137926,5.781895934856948,25147,5.92,5.92,5.75,5.75,5.92,5.92,5.75,5.75,54.95606930585179,66.19057311937294,NaN,NaN,NaN,NaN,0.01654376431872029,0.1309917749269367,0.11444801060821641,-11946823,0.10995779533763071
1740517200,5.79,5.83,5.74,5.74,5.811202333710341,5.7759108013059555,44386,5.83,5.83,5.74,5.74,5.79,5.83,5.74,5.74,54.38989135995514,65.59091593166417,NaN,NaN,NaN,NaN,0.002064677133980203,0.11702885702569166,0.11496417989171145,-11991209,0.10853223852779993
1740603600,5.81,5.9,5.81,5.9,5.828961866968273,5.793637829690819,138876,5.9,5.9,5.81,5.81,5.81,5.9,5.81,5.9,61.26588665704427,65.1036800264238,NaN,NaN,NaN,NaN,0.002043951733520122,0.1175191195586116,0.11547516782509148,-11852333,0.11220850720438566
1740690000,5.9,5.93,5.89,5.89,5.841169493574618,5.807403854020701,61799,5.93,5.93,5.89,5.89,5.9,5.93,5.89,5.89,60.65046426402768,64.53427613003097,NaN,NaN,NaN,NaN,0.0002328724257190523,0.1157662583572403,0.11553338593152125,-11914132,0.10705075668978668
1740949200,5.93,5.94,5.88,5.93,5.858935594859695,5.8249175891606,11565,5.94,5.94,5.88,5.88,5.93,5.94,5.88,5.93,62.28254495812993,63.8959030718484,NaN,NaN,NaN,NaN,0.0005849261712159437,0.11626454364554117,0.11567961747432523,-11902567,0.10368998835480195
1741035600,5.92,6,5.9,6,5.887148475887756,5.849929362137658,63055,6,6,5.9,5.9,5.92,6,5.9,6,65.01706429484736,63.944500021946574,NaN,NaN,NaN,NaN,0.004187531318057464,0.12091403162189707,0.1167265003038396,-11839512,0.10342641775803037
1741122000,5.9,5.98,5.9,5.98,5.905718780710204,5.868510881832279,17999,5.98,5.98,5.9,5.9,5.9,5.98,5.9,5.98,63.59833031539748,64.45177190172669,NaN,NaN,NaN,NaN,0.0038855306202808526,0.12158341357919067,0.11769788295890982,-11857511,0.10318167363245676
1741208400,5.91,6,5.91,5.99,5.922575024568164,5.885866470141954,43901,6,6,5.91,5.91,5.91,6,5.91,5.99,64.02107339289884,64.98923971561405,NaN,NaN,NaN,NaN,0.0030577040037779446,0.12152001296363224,0.1184623089598543,-11813610,0.1022401255158527
1741294800,5.95,6,5.9,6,5.938060019654531,5.9021712601216745,21358,6,6,5.9,5.9,5.95,6,5.9,6,64.4654899346037,65.17366390984398,NaN,NaN,NaN,NaN,0.0019367268015791084,0.12088321746182817,0.11894649066024907,-11792252,0.10208011655043461
1741554000,5.95,6.01,5.95,6.01,5.952448015723625,5.9175753658185775,57090,6.01,6.01,5.95,5.95,5.95,6.01,5.95,6.01,64.93197527518478,64.52502878067561,NaN,NaN,NaN,NaN,0.0006863577766633988,0.11980443788107831,0.11911808010441491,-11735162,0.09907439393968927
1741640400,6.03,6.04,5.95,6.04,5.9699584125789,5.935064599273066,86138,6.04,6.04,5.95,5.95,6.03,6.04,5.95,6.04,66.35878253683512,63.6743369859296,NaN,NaN,NaN,NaN,0.000695223802571851,0.11998710985762973,0.11929188605505787,-11649024,0.09842622294399717
1741726800,5.98,6.03,5.95,5.95,5.96596673006312,5.937198227948343,88344,6.03,6.03,5.95,5.95,5.98,6.03,5.95,5.95,58.64933845471391,62.61976003324406,NaN,NaN,NaN,NaN,-0.006166815022624367,0.11158336727677742,0.11775018229940179,-11737368,0.09782434987656878
1741813200,5.98,6.03,5.94,6.01,5.974773384050496,5.94759848109858,24427,6.03,6.03,5.94,5.94,5.98,6.03,5.94,6.01,61.83285933728857,61.9068003694968,NaN,NaN,NaN,NaN,-0.007388979491242134,0.10851395793534913,0.11590293742659126,-11712941,0.09726546774252813
1741899600,6,6,5.92,5.92,5.963818707240397,5.94365584094164,35753,6,6,5.92,5.92,6,6,5.92,5.92,54.99354030704481,61.243807885273114,NaN,NaN,NaN,NaN,-0.014567920688456276,0.09769303656602091,0.11226095725447718,-11748694,0.09674650576091896
1742158800,5.92,5.92,5.9,5.9,5.951054965792317,5.937419292235691,13476,5.92,5.92,5.9,5.9,5.92,5.92,5.9,5.9,53.57536206908659,61.14518593978989,NaN,NaN,NaN,NaN,-0.02060368247174342,0.0865063541647979,0.10711003663654133,-11762170,0.09126461249228186
1742245200,5.92,5.92,5.87,5.89,5.938843972633854,5.930645107630592,17425,5.92,5.92,5.87,5.87,5.92,5.92,5.87,5.89,52.841609120226636,61.03459435123785,NaN,NaN,NaN,NaN,-0.024921380340917607,0.07595831121039431,0.10087969155131192,-11779595,0.08831714017140457
1742331600,5.88,5.89,5.7,5.8,5.911075178107083,5.911981520826221,67365,5.89,5.89,5.7,5.7,5.88,5.89,5.7,5.8,46.649244101667726,59.990548454425245,NaN,NaN,NaN,NaN,-0.03298450041473354,0.05964906603289499,0.09263356644762853,-11846960,0.0955802015877328
1742418000,5.8,5.85,5.71,5.71,5.870860142485666,5.883127017851047,31418,5.85,5.85,5.71,5.71,5.8,5.85,5.71,5.71,41.42174904357506,58.61706879582148,NaN,NaN,NaN,NaN,-0.04289731813906669,0.03901191877379517,0.08190923691286187,-11878378,0.09875304433146614
1742504400,5.75,5.88,5.75,5.87,5.870688113988533,5.881251729586611,76063,5.88,5.88,5.75,5.75,5.75,5.88,5.75,5.87,51.76924444374535,57.866118759079725,NaN,NaN,NaN,NaN,-0.03739765661119107,0.03516216614887302,0.07255982276006409,-11802315,0.10384211259350427
1742763600,5.85,5.86,5.84,5.85,5.866550491190826,5.876787196788524,47417,5.86,5.86,5.84,5.84,5.85,5.86,5.84,5.85,50.56681625502112,56.83395818480642,NaN,NaN,NaN,NaN,-0.033927995685418086,0.03014982815329148,0.06407782383870957,-11849732,0.09856767597968255
1742850000,5.87,5.87,5.85,5.86,5.865240392952661,5.8743890258187355,19702,5.87,5.87,5.85,5.85,5.87,5.87,5.85,5.86,51.177424543693384,55.94675062968469,NaN,NaN,NaN,NaN,-0.02992072648884244,0.026676915727656514,0.056597642216498954,-11830030,0.09295569912399097
1742936400,5.85,5.86,5.82,5.83,5.858192314362128,5.868047736416059,36965,5.86,5.86,5.82,5.82,5.85,5.86,5.82,5.83,49.213458661110764,54.889063863128406,NaN,NaN,NaN,NaN,-0.028271073681011907,0.021258800115234067,0.049529873796245974,-11866995,0.08917314918656305
1743022800,5.81,5.85,5.81,5.85,5.856553851489703,5.865469488356622,36904,5.85,5.85,5.81,5.81,5.81,5.85,5.81,5.85,50.57519766764813,53.896900129774444,NaN,NaN,NaN,NaN,-0.02493028799068374,0.018367013807891297,0.043297301798575036,-11830091,0.08566078138752284
1743109200,5.85,5.85,5.81,5.81,5.847243081191762,5.857545275734247,15929,5.85,5.85,5.81,5.81,5.85,5.85,5.81,5.81,47.81389481743997,52.674180097078384,NaN,NaN,NaN,NaN,-0.024476901138417592,0.012701175375553042,0.037178076513970634,-11846020,0.08239929700269978
1743368400,5.78,5.85,5.78,5.82,5.84179446495341,5.8521816649150695,62896,5.85,5.85,5.78,5.78,5.78,5.85,5.78,5.82,48.56988926152832,51.40354486312789,NaN,NaN,NaN,NaN,-0.022610376227874332,0.008915106229127723,0.031525482457002055,-11783124,0.08151363293107831
1743454800,5.85,5.87,5.8,5.87,5.847435571962728,5.854727141355774,43140,5.87,5.87,5.8,5.8,5.85,5.87,5.8,5.87,52.29136663188836,50.94940401864035,NaN,NaN,NaN,NaN,-0.017351729905794422,0.009835820074759027,0.02718754998055345,-11739984,0.08069123057885845
1743541200,5.87,5.88,5.86,5.87,5.851948457570182,5.856908978304949,51805,5.88,5.88,5.86,5.86,5.87,5.88,5.86,5.87,52.29136663188835,50.267868825397485,NaN,NaN,NaN,NaN,-0.013393969617514268,0.010445087958660615,0.023839057576174882,-11739984,0.07635614268036853
1743627600,5.85,5.87,5.77,5.86,5.853558766056145,5.857350552832813,12771,5.87,5.87,5.77,5.77,5.85,5.87,5.77,5.86,51.42819224667493,50.013201106799634,NaN,NaN,NaN,NaN,-0.01106670089916566,0.010005681452217807,0.021072382351383468,-11752755,0.07804498963177083
1743714000,5.88,5.88,5.74,5.75,5.832847012844916,5.842014759570982,30943,5.88,5.88,5.74,5.74,5.88,5.88,5.74,5.75,43.01653860811307,49.258999431015816,NaN,NaN,NaN,NaN,-0.01623993511267855,0.0007724634605352776,0.01701239857321383,-11783698,0.08247034751521574
1743976800,5.77,5.77,5.56,5.58,5.7822776102759335,5.80458407963227,31532,5.77,5.77,5.56,5.56,5.77,5.77,5.56,5.58,33.81216860271756,47.89975367976517,NaN,NaN,NaN,NaN,-0.029635195501094842,-0.020031595803154723,0.009603599697940118,-11815230,0.09157960840698605
1744063200,5.56,5.83,5.56,5.75,5.775822088220747,5.796786353970517,54023,5.83,5.83,5.56,5.56,5.56,5.83,5.56,5.75,46.20765951469617,47.86821192355291,NaN,NaN,NaN,NaN,-0.025716110621507672,-0.022541538578944476,0.0031745720425631983,-11761207,0.10432392209220136
1744149600,5.78,5.8,5.7,5.7,5.760657670576598,5.782959731974729,9789,5.8,5.8,5.7,5.7,5.78,5.8,5.7,5.7,43.6201694324545,48.02524195133002,NaN,NaN,NaN,NaN,-0.025131448289857944,-0.028239738319759233,-0.0031082900299012877,-11770996,0.10401507051418694
1744236000,5.75,5.8,5.75,5.76,5.760526136461278,5.779679770264053,47062,5.8,5.8,5.75,5.75,5.75,5.8,5.75,5.76,47.42479258584927,47.71492396148029,NaN,NaN,NaN,NaN,-0.019590163704126185,-0.02759599466005902,-0.008005830955932835,-11723934,0.10372827976317356
1744322400,5.75,5.8,5.74,5.8,5.768420909169023,5.782582660226331,45446,5.8,5.8,5.74,5.74,5.75,5.8,5.74,5.8,49.85428278644107,47.66402871372457,NaN,NaN,NaN,NaN,-0.012464350940377091,-0.0235862696314042,-0.011121918691027109,-11678488,0.10060483120866114
1744581600,5.71,5.8,5.71,5.75,5.764736727335218,5.777927994479712,11901,5.8,5.8,5.71,5.71,5.71,5.8,5.71,5.75,46.93468667649592,47.36097600892476,NaN,NaN,NaN,NaN,-0.010434114458500218,-0.02416456176415238,-0.013730447305652163,-11690389,0.09984734326518532
1744668000,5.82,5.82,5.77,5.79,5.769789381868175,5.779652566696896,21188,5.82,5.82,5.77,5.77,5.82,5.82,5.77,5.79,49.48344523917537,47.380260764500804,NaN,NaN,NaN,NaN,-0.005936743622524198,-0.02115137683380741,-0.015214633211283213,-11669201,0.09771539017481497
1744754400,5.78,5.79,5.77,5.79,5.77383150549454,5.781130771454483,12588,5.79,5.79,5.77,5.77,5.78,5.79,5.77,5.79,49.48344523917536,47.30227844818132,NaN,NaN,NaN,NaN,-0.0026679558936198583,-0.018549578078308038,-0.01588162218468818,-11669201,0.09216429087661393
1744840800,5.79,5.8,5.72,5.8,5.779065204395632,5.7838263755324135,16876,5.8,5.8,5.72,5.72,5.79,5.8,5.72,5.8,50.17727798297274,47.47109153143366,NaN,NaN,NaN,NaN,0.000303681940546717,-0.015502019759004781,-0.0158057016995515,-11652325,0.0912954129568558
1745272800,5.8,5.8,5.76,5.8,5.783252163516505,5.786136893313497,53467,5.8,5.8,5.76,5.76,5.8,5.8,5.76,5.8,50.17727798297274,47.58590501153684,NaN,NaN,NaN,NaN,0.0022944250210282287,-0.012937670423266212,-0.01523209544429444,-11652325,0.08763145488850896
1745359200,5.8,5.8,5.74,5.74,5.774601730813204,5.779545908554426,33146,5.8,5.8,5.74,5.74,5.8,5.8,5.74,5.74,45.79997207900383,47.12223397204508,NaN,NaN,NaN,NaN,-0.0002682850566329848,-0.015567451765085671,-0.015299166708452687,-11685471,0.08565777953932972
1745445600,5.75,5.77,5.73,5.75,5.769681384650563,5.775325064475223,19502,5.77,5.77,5.73,5.73,5.75,5.77,5.73,5.75,46.63554680774478,46.718246841749114,NaN,NaN,NaN,NaN,-0.001082821918673706,-0.01665269410679482,-0.015569872188121113,-11665969,0.08239650957223468
1745791200,5.8,5.81,5.72,5.8,5.775745107720451,5.778850055264477,147028,5.81,5.81,5.72,5.72,5.8,5.81,5.72,5.8,50.72588577881998,46.66808209404519,NaN,NaN,NaN,NaN,0.0017962362142505996,-0.013324576920307862,-0.015120813134558462,-11518941,0.08293961603136077
1745877600,5.8,5.8,5.75,5.8,5.78059608617636,5.78187147594098,13102,5.8,5.8,5.75,5.75,5.8,5.8,5.75,5.8,50.72588577881998,47.218749749095686,NaN,NaN,NaN,NaN,0.0036444659718910775,-0.010565230669694614,-0.014209696641585692,-11518941,0.08058678631483499
1745964000,5.8,5.8,5.75,5.8,5.784476868941089,5.7844612650922675,35251,5.8,5.8,5.75,5.75,5.8,5.8,5.75,5.8,50.72588577881998,48.42687240453156,NaN,NaN,NaN,NaN,0.004741398741267685,-0.008282948215001085,-0.01302434695626877,-11518941,0.07840201586377533
1746050400,5.77,5.85,5.76,5.85,5.797581495152871,5.793823941507658,176338,5.85,5.85,5.76,5.76,5.77,5.85,5.76,5.85,55.03090806719424,49.057104443995705,NaN,NaN,NaN,NaN,0.008490006669141096,-0.002411838619842399,-0.010901845288983495,-11342603,0.07923044330207708
1746136800,5.84,5.89,5.84,5.89,5.816065196122296,5.807563378435136,170448,5.89,5.89,5.84,5.84,5.84,5.89,5.84,5.89,58.17885341697293,50.09701044288988,NaN,NaN,NaN,NaN,0.013046597912288302,0.005406402101376884,-0.0076401958109114185,-11172155,0.07714255449478584
1746396000,5.89,5.96,5.89,5.94,5.840852156897837,5.826482895801545,125713,5.96,5.96,5.89,5.89,5.89,5.96,5.89,5.94,61.78043686095185,51.122413605397206,NaN,NaN,NaN,NaN,0.018479194204314504,0.015458796944481712,-0.0030203972598327926,-11046442,0.07663237203087259
1746482400,5.94,5.99,5.94,5.99,5.87068172551827,5.84984248211561,43131,5.99,5.99,5.94,5.94,5.94,5.99,5.94,5.99,65.02420513844481,52.205979487683194,NaN,NaN,NaN,NaN,0.024133949993823803,0.027147040232446962,0.003013090238623158,-11003311,0.0747300597429531
1746568800,5.95,5.97,5.95,5.95,5.886545380414616,5.864150698956237,14175,5.97,5.97,5.95,5.95,5.95,5.97,5.95,5.95,60.59357639623709,53.18161446766471,NaN,NaN,NaN,NaN,0.023832923512462946,0.03280424462920184,0.008971321116738894,-11017486,0.07224934118988502
1746655200,5.95,5.99,5.95,5.99,5.907236304331693,5.882129170533918,30326,5.99,5.99,5.95,5.95,5.95,5.99,5.95,5.99,63.2875212425371,54.16761989647625,NaN,NaN,NaN,NaN,0.024865801443794605,0.04005357292148215,0.015187771477687545,-10987160,0.06994581681917895
1746741600,5.99,6.02,5.97,5.97,5.919789043465355,5.894682146171929,28781,6.02,6.02,5.97,5.97,5.99,6.02,5.97,5.97,61.04056352239648,54.99312834527776,NaN,NaN,NaN,NaN,0.022794865630686112,0.043681353516045185,0.020886487885359073,-11015941,0.06852111561780902
1747000800,6,6.04,6,6.04,5.943831234772284,5.915441839575939,24175,6.04,6.04,6,6,6,6.04,6,6.04,65.63886127880642,56.09752715212302,NaN,NaN,NaN,NaN,0.024578717004698537,0.05160988414123224,0.027031167136533706,-10991766,0.06862675021653697
1747087200,6.04,6.22,6.04,6.22,5.999064987817827,5.958950148207947,75776,6.22,6.22,6.04,6.04,6.04,6.22,6.04,6.22,74.10315065060254,57.80651805695373,NaN,NaN,NaN,NaN,0.03564908502338561,0.07159252341576572,0.03594343839238011,-10915990,0.07658198234392717
1747173600,6.27,6.33,6.21,6.23,6.045251990254262,5.9976715556068125,46952,6.33,6.33,6.21,6.21,6.27,6.33,6.21,6.23,74.47927217587106,59.855039492444234,NaN,NaN,NaN,NaN,0.04102948045593681,0.08723028896230112,0.04620080850636431,-10869038,0.07968326931936096
1747260000,6.23,6.23,6.13,6.17,6.07020159220341,6.022289904805839,14405,6.23,6.23,6.13,6.13,6.23,6.23,6.13,6.17,68.08933908476284,61.38745322651696,NaN,NaN,NaN,NaN,0.03800071113272133,0.09370169742226597,0.05570098628954464,-10883443,0.08113446436797807
1747346400,6.08,6.15,6,6.09,6.074161273762728,6.0319627755478615,22085,6.15,6.15,6,6,6.08,6.15,6,6.09,60.62125453181335,62.094265280302196,NaN,NaN,NaN,NaN,0.028497048762134658,0.09132229724221297,0.06282524848007831,-10905528,0.08748200262740821
1747605600,6.05,6.15,6.05,6.15,6.089329019010183,6.048825236183881,27154,6.15,6.15,6.05,6.05,6.05,6.15,6.05,6.15,63.82585796689297,63.02997757945026,NaN,NaN,NaN,NaN,0.024302768950486442,0.09320370966818636,0.06890094071769992,-10878374,0.0883761452968791
1747692000,6.15,6.17,6.12,6.15,6.101463215208146,6.0632787738718985,16366,6.17,6.17,6.12,6.12,6.15,6.17,6.12,6.15,63.82585796689297,63.96568987859833,NaN,NaN,NaN,NaN,0.019771727589950314,0.09361560020513782,0.0738438726151875,-10878374,0.08563499206138772
1747778400,6.15,6.15,6.07,6.07,6.095170572166517,6.064238949033055,32961,6.15,6.15,6.07,6.07,6.15,6.15,6.07,6.07,56.69173968894395,64.08432070872333,NaN,NaN,NaN,NaN,0.010116658418036759,0.08648969563773345,0.0763730372196967,-10911335,0.08523249262843147
1747864800,6.01,6.07,6.01,6.07,6.090136457733214,6.0650619563140475,13201,6.07,6.07,6.01,6.01,6.01,6.07,6.01,6.07,56.69173968894395,63.97809829957839,NaN,NaN,NaN,NaN,0.0028384377575926822,0.07992108441668755,0.07708264665909487,-10911335,0.08343017172640067
1747951200,6.07,6.08,6,6,6.072109166186571,6.055767391126326,43863,6.08,6.08,6,6,6.07,6.08,6,6,50.916385428656525,63.20209462584301,NaN,NaN,NaN,NaN,-0.0070421897904032055,0.06827990942109086,0.07532209921149406,-10955198,0.0831851594602292
1748210400,6.14,6.23,6.11,6.2,6.097687332949257,6.076372049536851,128546,6.23,6.23,6.11,6.11,6.14,6.23,6.11,6.2,62.63015713013776,63.031091196678226,NaN,NaN,NaN,NaN,-0.0007891769296975715,0.0743356280493721,0.07512480497906968,-10826652,0.09367193378449858
1748296800,6.2,6.25,6.2,6.2,6.118149866359405,6.0940331853173015,193537,6.25,6.25,6.2,6.2,6.2,6.25,6.2,6.2,62.63015713013776,63.17656124909969,NaN,NaN,NaN,NaN,0.0024865618421786168,0.07823300728179294,0.07574644543961433,-10826652,0.09055250994274866
1748383200,6.2,6.2,6.17,6.17,6.128519893087525,6.10488558741483,84842,6.2,6.2,6.17,6.17,6.2,6.2,6.17,6.17,60.133619098048364,62.95128252449336,NaN,NaN,NaN,NaN,0.0018042859632894648,0.07800180289372616,0.07619751693043669,-10911494,0.08622733066112377
1748469600,6.2,6.22,6.15,6.18,6.13881591447002,6.115616217784139,89900,6.22,6.22,6.15,6.15,6.2,6.22,6.15,6.18,60.69603102503919,62.92667306039641,NaN,NaN,NaN,NaN,0.0012255634297922702,0.07772947121767704,0.07650390778788477,-10821594,0.0850682356139006
1748556000,6.17,6.5,6.17,6.5,6.211052731576016,6.1705281866721196,62523,6.5,6.5,6.17,6.17,6.17,6.5,6.17,6.5,73.55340221732803,63.49199741314795,NaN,NaN,NaN,NaN,0.020522766195037317,0.10215736553168142,0.0816345993366441,-10759071,0.10256336164147914
1748901600,6.48,6.49,6.4,6.4,6.248842185260813,6.2033098742903885,55639,6.49,6.49,6.4,6.4,6.48,6.49,6.4,6.4,66.25891452652664,62.93169483285681,NaN,NaN,NaN,NaN,0.024416028281897775,0.11215463468901632,0.08773860640711854,-10814710,0.10238026438137346
1748988000,6.4,6.4,6.29,6.3,6.2590737482086505,6.217122749391761,26547,6.4,6.4,6.29,6.29,6.4,6.4,6.29,6.3,59.86522780633432,61.88783452074705,NaN,NaN,NaN,NaN,0.0183946584762556,0.11073192950243804,0.09233727102618244,-10841257,0.10292453121127539
1749074400,6.35,6.4,6.3,6.4,6.28725899856692,6.243248070907223,30155,6.4,6.4,6.3,6.3,6.35,6.4,6.3,6.4,63.64334667951787,61.570263634658126,NaN,NaN,NaN,NaN,0.019196247249793477,0.11633258008842429,0.09713633283863081,-10811102,0.10271563612475576
1749160800,6.4,6.47,6.4,6.44,6.3178071988535365,6.271355489349048,45063,6.47,6.47,6.4,6.4,6.4,6.47,6.4,6.44,65.0601843647375,61.88733005129556,NaN,NaN,NaN,NaN,0.020359501710472794,0.1225857099767218,0.10222620826624901,-10766039,0.10037880497298746
1749420000,6.44,6.45,6.3,6.42,6.338245759082829,6.292590419442042,47317,6.45,6.45,6.3,6.3,6.44,6.45,6.3,6.42,63.723012628959694,61.87998395572889,NaN,NaN,NaN,NaN,0.017812998244447126,0.12449245607180792,0.1066794578273608,-10813356,0.10392317604634552
1749506400,6.42,6.45,6.4,6.45,6.360596607266263,6.315077502378893,50387,6.45,6.45,6.4,6.4,6.42,6.45,6.4,6.45,64.8887328870369,61.955903592882024,NaN,NaN,NaN,NaN,0.016225066064187985,0.12696079040759578,0.1107357243434078,-10762969,0.10007152061446369
1749592800,6.47,6.49,6.45,6.45,6.378477285813011,6.334352144896195,29140,6.49,6.49,6.45,6.45,6.47,6.49,6.45,6.45,64.8887328870369,62.54140310703152,NaN,NaN,NaN,NaN,0.013369679701974252,0.12744782397087562,0.11407814426890137,-10762969,0.09578069771343056
1749679200,6.49,6.59,6.46,6.59,6.420781828650409,6.370873267053881,58031,6.59,6.59,6.46,6.46,6.49,6.59,6.46,6.59,70.09047475776828,63.498455611947534,NaN,NaN,NaN,NaN,0.01877356241461252,0.13754509728716702,0.1187715348725545,-10704938,0.09893921930532835
1749765600,6.59,6.59,6.5,6.56,6.448625462920327,6.39789137176047,34240,6.59,6.59,6.5,6.5,6.59,6.59,6.5,6.56,67.77340297027571,64.70252829349177,NaN,NaN,NaN,NaN,0.01817912291820066,0.14149543852030533,0.12331631560210467,-10739178,0.09830070364066203
1750024800,6.57,6.7,6.57,6.7,6.498900370336261,6.441049747223261,24374,6.7,6.7,6.57,6.57,6.57,6.7,6.57,6.7,72.36470675846216,65.3978532669435,NaN,NaN,NaN,NaN,0.024663781719248407,0.15414604275116517,0.12948226103191676,-10714804,0.1012792248091862
1750111200,6.7,6.75,6.7,6.72,6.5431202962690085,6.480899783334223,26718,6.75,6.75,6.7,6.7,6.7,6.75,6.7,6.72,72.95743564888775,66.1355160182828,NaN,NaN,NaN,NaN,0.02753121225285013,0.16389627634797943,0.1363650640951293,-10688086,0.09761642303710147
1750197600,6.72,6.72,6.5,6.5,6.534496237015206,6.483628385715049,23891,6.72,6.72,6.5,6.5,6.72,6.72,6.5,6.5,58.17609153438451,65.99569262087823,NaN,NaN,NaN,NaN,0.012602130221042146,0.152117726871432,0.13951559665038984,-10711977,0.10635810710587991
1750284000,6.5,6.64,6.45,6.64,6.555596989612165,6.505967187755756,83189,6.64,6.64,6.45,6.45,6.5,6.64,6.45,6.64,63.275195817287155,66.17991867746737,NaN,NaN,NaN,NaN,0.01024678220866021,0.1523240744112151,0.14207729220255488,-10628788,0.11233252802688845
1750629600,6.72,6.75,6.61,6.69,6.582477591689732,6.532257589504932,45715,6.75,6.75,6.61,6.61,6.72,6.75,6.61,6.69,64.92014946541362,65.56325776661635,NaN,NaN,NaN,NaN,0.010128934087829722,0.15473845981234202,0.1446095257245123,-10583073,0.11430877602496782
1750716000,6.72,6.72,6.69,6.72,6.609982073351786,6.55907793386137,73692,6.72,6.72,6.69,6.69,6.72,6.72,6.69,6.72,65.90687622217061,65.53811217344806,NaN,NaN,NaN,NaN,0.010120246178663861,0.1572598334478421,0.14713958726917825,-10509381,0.10828672059461293
1750802400,6.72,6.85,6.72,6.85,6.6579856586814286,6.600638229024031,58762,6.85,6.85,6.72,6.72,6.72,6.85,6.72,6.85,69.86280754310631,66.25222501178892,NaN,NaN,NaN,NaN,0.016539133503548742,0.16781350414861418,0.15127437064506544,-10450619,0.10983766912356915
1750888800,6.83,6.84,6.8,6.84,6.694388526945143,6.634832767734884,34934,6.84,6.84,6.8,6.8,6.83,6.84,6.8,6.84,69.19766501159756,66.6489620355089,NaN,NaN,NaN,NaN,0.017678042816783257,0.17337192416604452,0.15569388134926126,-10485553,0.10556354990045705
1750975200,6.84,6.9,6.75,6.9,6.735510821556114,6.672713800915615,24318,6.9,6.9,6.75,6.75,6.84,6.9,6.75,6.9,70.9827576355819,67.07200298342636,NaN,NaN,NaN,NaN,0.019874805326085848,0.18053738800686858,0.16066258268078273,-10461235,0.10873758205042443
1751234400,6.97,7.06,6.97,7,6.788408657244892,6.719468972213384,46031,7.06,7.06,6.97,6.97,6.97,7.06,6.97,7,73.71670619349973,67.78583823803636,NaN,NaN,NaN,NaN,0.025126859655054068,0.19207115724960033,0.16694429759454626,-10415204,0.11239918333253691
1751320800,7,7,6.96,7,6.830726925795913,6.759544833325757,35662,7,7,6.96,6.96,7,7,6.96,7,73.71670619349973,68.41640775992656,NaN,NaN,NaN,NaN,0.025579554761657214,0.19891874104661778,0.17333918628496056,-10415204,0.10722781309449857
1751407200,6.97,7.1,6.96,7.1,6.884581540636731,6.808181285707792,21104,7.1,7.1,6.96,6.96,6.97,7.1,6.96,7.1,76.30578835026454,69.23191172158569,NaN,NaN,NaN,NaN,0.02932383886344117,0.20999398486426202,0.18067014600082085,-10394100,0.10956868358774864
1751493600,7.2,7.2,7.05,7.1,6.927665232509384,6.849869673463822,38350,7.2,7.2,7.05,7.05,7.2,7.2,7.05,7.1,76.30578835026454,69.67586269247828,NaN,NaN,NaN,NaN,0.028486344276838715,0.21627807634686924,0.18779173207003053,-10394100,0.11245663476005233
1751580000,7.1,7.11,7.04,7.1,6.962132186007508,6.885602577254704,22841,7.11,7.11,7.04,7.04,7.1,7.11,7.04,7.1,76.30578835026454,70.28531879104891,NaN,NaN,NaN,NaN,0.024756056281481614,0.21873680242188254,0.19398074614040092,-10394100,0.10942401799147718
1751839200,7.1,7.1,7,7,6.969705748806006,6.9019450662183175,35367,7.1,7.1,7,7,7.1,7.1,7,7,67.9461936061963,69.9697107087442,NaN,NaN,NaN,NaN,0.012969978839296126,0.2101932196895211,0.19722324085022497,-10429467,0.10875087384922878
1751925600,7,7,6.95,6.99,6.973764599044805,6.914524342472844,60097,7,7,6.95,6.95,7,7,6.95,6.99,67.15390448515726,69.55517276847773,NaN,NaN,NaN,NaN,0.002466562831760888,0.20030644438992606,0.19783988155816518,-10489564,0.10455438285999814
1752012000,7,7.02,6.95,6.99,6.977011679235844,6.925306579262438,16604,7.02,7.02,6.95,6.95,7,7.02,6.95,6.99,67.15390448515726,70.19644512210435,NaN,NaN,NaN,NaN,-0.006049744572079824,0.1902777008430654,0.1963274454151452,-10489564,0.10208621265571252
1752098400,6.94,6.94,6.8,6.88,6.9576093433886745,6.918834210796375,44222,6.94,6.94,6.8,6.8,6.94,6.94,6.8,6.88,58.457829106407736,69.85234749989868,NaN,NaN,NaN,NaN,-0.01988028632150171,0.17147708751326807,0.19135737383476978,-10533786,0.10836576889459024
1752184800,6.88,6.88,6.71,6.73,6.9120874747109395,6.891857894968321,38177,6.88,6.88,6.71,6.71,6.88,6.88,6.71,6.73,49.11733087268266,68.72357474327505,NaN,NaN,NaN,NaN,-0.038824062711326573,0.14282729544561157,0.18165135815693814,-10571963,0.11276821397354807
1752444000,6.75,6.82,6.71,6.8,6.889669979768752,6.878735338544274,31442,6.82,6.82,6.71,6.71,6.75,6.82,6.71,6.8,52.899527375117934,67.794478397057,NaN,NaN,NaN,NaN,-0.045851277520372796,0.12433726125647215,0.17018853877684495,-10540521,0.11257048440400895
1752530400,6.84,6.85,6.79,6.8,6.871735983815001,6.867487433037949,15109,6.85,6.85,6.79,6.79,6.84,6.85,6.79,6.8,52.899527375117934,66.58281552791497,NaN,NaN,NaN,NaN,-0.049403776311544356,0.1084338183874145,0.15783759469895886,-10540521,0.10881544980372257
1752616800,6.8,6.8,6.7,6.7,6.837388787052001,6.843560656889671,23738,6.8,6.8,6.7,6.7,6.8,6.8,6.7,6.7,47.0991220527697,65.00434817371298,NaN,NaN,NaN,NaN,-0.05686132774448441,0.08676093501835336,0.14362226276283777,-10564259,0.10818577481774236
1752703200,6.77,6.79,6.7,6.72,6.813911029641601,6.82590913447686,32735,6.79,6.79,6.7,6.7,6.77,6.79,6.7,6.72,48.319647110424086,63.38555456477314,NaN,NaN,NaN,NaN,-0.05858783522479591,0.07038746873184287,0.12897530395663878,-10531524,0.10688679090218932
1752789600,6.7,6.79,6.7,6.7,6.791128823713281,6.807922115265881,64122,6.79,6.79,6.7,6.7,6.7,6.79,6.7,6.7,47.148171218176174,61.48780206653574,NaN,NaN,NaN,NaN,-0.05905090203446457,0.05516167641355807,0.11421257844802264,-10595646,0.10568059155203292
1753048800,6.79,6.83,6.75,6.77,6.7869030589706245,6.802504670227898,19716,6.83,6.83,6.75,6.75,6.79,6.83,6.75,6.77,51.57349877675069,59.906144393910814,NaN,NaN,NaN,NaN,-0.05281961528724649,0.04818805933896453,0.10100767462621102,-10575930,0.10741769215545914
1753135200,6.72,6.79,6.72,6.73,6.7755224471765,6.7921468601953405,26861,6.79,6.79,6.72,6.72,6.72,6.79,6.72,6.73,49.04630616949586,57.9590385238559,NaN,NaN,NaN,NaN,-0.049618648202148605,0.03898436437352526,0.08860301257567386,-10602791,0.10474499985864065
1753221600,6.75,6.81,6.75,6.81,6.7824179577412,6.794697308738863,5651,6.81,6.81,6.75,6.75,6.75,6.81,6.75,6.81,53.91067780685536,56.35938777075525,NaN,NaN,NaN,NaN,-0.04071361616397556,0.03771099237070441,0.07842460853467997,-10597140,0.10297749986873769
1753308000,6.85,6.91,6.81,6.81,6.787934366192959,6.796883407490455,44270,6.91,6.91,6.81,6.81,6.85,6.91,6.81,6.81,53.91067780685536,54.759737017654594,NaN,NaN,NaN,NaN,-0.033712821752282046,0.03628358134432741,0.06999640309660946,-10597140,0.10276482130668504
1753394400,6.84,6.84,6.72,6.75,6.780347492954368,6.790185777848961,21847,6.84,6.84,6.72,6.72,6.84,6.84,6.72,6.75,49.77723024834893,53.4619539206655,NaN,NaN,NaN,NaN,-0.03202478129386275,0.02996542647928102,0.06199020777314377,-10618987,0.10399590549906469
1753653600,6.82,6.82,6.7,6.7,6.7642779943634945,6.7773020952991105,18878,6.82,6.82,6.7,6.7,6.82,6.82,6.7,6.7,46.57264395354062,51.99186388269288,NaN,NaN,NaN,NaN,-0.03304399436569943,0.02068521481601948,0.05372920918171891,-10637865,0.10513905510627437
1753740000,6.72,6.72,6.65,6.65,6.741422395490796,6.759116081684952,24331,6.72,6.72,6.65,6.65,6.72,6.72,6.65,6.65,43.55307630971398,50.30609044158979,NaN,NaN,NaN,NaN,-0.035631318721415665,0.009190060779949327,0.04482137950136499,-10662196,0.1026291225986833
1753826400,6.7,6.81,6.67,6.73,6.739137916392637,6.754956641444244,50846,6.81,6.81,6.67,6.67,6.7,6.81,6.67,6.73,49.2254474667336,49.64663461018449,NaN,NaN,NaN,NaN,-0.030688365753290543,0.006460922309751815,0.03714928806304236,-10611350,0.10672704241306301
1753912800,6.8,6.85,6.72,6.85,6.76131033311411,6.7685342640950665,30591,6.85,6.85,6.72,6.72,6.8,6.85,6.72,6.85,56.31659873991091,50.16086802927223,NaN,NaN,NaN,NaN,-0.018662047060850423,0.01382172923697933,0.03248377629782975,-10580759,0.10838939652641565
1753999200,6.85,6.88,6.8,6.83,6.775048266491288,6.777315083510056,13495,6.88,6.88,6.8,6.8,6.85,6.88,6.8,6.83,54.939426685360935,50.30657512286101,NaN,NaN,NaN,NaN,-0.011718389812692576,0.017835789031964033,0.02955417884465661,-10594254,0.10636158248881454
1754258400,6.79,6.95,6.79,6.88,6.79603861319303,6.791984357294334,65587,6.95,6.95,6.79,6.79,6.79,6.95,6.79,6.88,57.72286754706628,50.65109942085733,NaN,NaN,NaN,NaN,-0.003830499229087625,0.024766054808297078,0.028596554037384703,-10528667,0.1101928980253278
1754344800,6.9,6.95,6.88,6.9,6.816830890554424,6.807415163395143,40302,6.95,6.95,6.88,6.88,6.9,6.95,6.88,6.9,58.81866523310451,51.488209648024096,NaN,NaN,NaN,NaN,0.002329922825866148,0.03150895756971739,0.02917903474385124,-10488365,0.10732197673780441
1754431200,6.93,7,6.92,6.95,6.84346471244354,6.827784425767267,41579,7,7,6.92,6.92,6.93,7,6.92,6.95,61.50496380263134,52.430017983181756,NaN,NaN,NaN,NaN,0.00899388111906646,0.04042138614268431,0.03142750502361785,-10446786,0.10679897839938979
1754517600,6.98,6.99,6.9,6.91,6.856771769954832,6.839529507800514,22507,6.99,6.99,6.9,6.9,6.98,6.99,6.9,6.91,58.23236361786374,53.22174601173087,NaN,NaN,NaN,NaN,0.009860021847948673,0.043752532333553695,0.03389251048560502,-10469293,0.10559905137086194
1754604000,6.88,6.95,6.81,6.81,6.847417415963865,6.8353110066861555,26277,6.95,6.95,6.81,6.81,6.88,6.95,6.81,6.81,50.935620215954735,53.1761832573883,NaN,NaN,NaN,NaN,0.00319526550834201,0.037886592371032535,0.034691326862690525,-10495570,0.10805626198722898
1754863200,6.81,6.87,6.78,6.78,6.833933932771092,6.827409434302419,12183,6.87,6.87,6.78,6.78,6.81,6.87,6.78,6.78,48.9538318011349,53.16957794536251,NaN,NaN,NaN,NaN,-0.0033803798649559846,0.030465852031495544,0.03384623189645153,-10507753,0.1067665289881412